1111111111111
10000P00P0001
10C111C000001
100000E000001
1111111111111
