1111111111111
10000P00P0001
10C111C000001
1000P0E000001
1111111111111
