1111111111111111111111111111111111111111111111111111111111111111111111111111
10000000000P0000000000000000000000000000000000000000000000000000000000000001
1C111C0000000000000000000000000000000000000000000000000000000000000000000001
1000000000011111100000000C00000000000000000000000000000000000000000000000001
10E00000000000000000000000000000000011100000C0000000000000000000000000000001
1C111C0000000000000000000000000000000000000000000000000000000000000000000001
100000000000000000000000000000000100000000C000000000000000000000000000000001
100000000000000000000000C000000000000000000000000000000000000000000000000001
1000000011111100000000C00000000000000000000000000000000000000000000000000001
10E00000000000000000000000000000000011100000C0000000000000000000000000000001
10000000C0000000000000000000000100000000000000000000000000000000000000000001
1000000000000000000000000000001C00000000000000000000000000000000000000000001
1000C00000000000000000000000000100000000000000000000000000000000000000000001
100000000000000000000000000000100C000000000000000000000000000000000000000001
100000000000C000000000000000000100000000000000000000000000000000000000000001
1000000000000000000000000000001000C00000000000000000000000000000000000000001
10000000000000000000C0000000000100000000000000000000000000000000000000000001
1000000000000000000000000000001000000C00000000000000000000000000000000000001
10000000000000000000000C0000000100000000000000000000000000000000000000000001
100000000000000000000000C000000100000000000000000000000000000000000000000001
1000000000000000000000000000000C00000000000000000000000000000000000000000001
1000000011111100000000000000000000000000000000C000000C0000000000000000000001
10000000000000000C0000000000000000000000000000000000000000000000000000000001
1000000011111100000000C00000000000000000000000000000000000000000000000000001
100000000C0000000000000C00000000000000000000C0000000000000000000000000000001
1000000011111100000000C00000000000000000000000000000000000000000000000000001
1000000011111100000000000000C00000C00000C00000C00000C00000C00000000000000001
1000000011111100C0000C000C00000000000C000000C0000C00000000000000000000000001
1000C0000C000000000000000000000000000000000000000000000000000000000000000001
100000C00000000C000000000000000000000000000000000000000000000000000000000001
10C00000000000000000000C000C00000000C000000000000000000000000000000000000001
1111111111111111111111111111111111111111111111111111111111111111111111111111
