11111111111111111111111111111111111111111111111111111111111111111111111111111111
10000000000P00000000000000000000000000000000000000C00000000000000000000000000001
1C111C00000000000000000000000000000000000000000000000000000000000000000000000001
1000000000011111100000000C00000000000000000000000000C000000000000000000000000001
10E00000000000000000000000000000000011100000C00000000000000000000000000000000001
1C111C000000000000000000000000000000000000000000000000C0000000000000000000000001
100000000000000000000000000000000100000000C0000000000000000000000000000000000001
100000000000000000000000C0000000000000000000000000000000C00000000000000000000001
1000000011111100000000C000000000000000000000000000000000000000000000000000000001
10E00000000000000000000000000000000011100000C00000000000000C00000000000000000001
100000000000000000000000000000100000000000C0000000000000000000000000000000000001
100000000000000000000000000000100000000000C0000000000000000000C00000000000000001
10000C0000000000000000000000000100000000000C000000000000000000000000000000000001
10000000C0000000000000000000000100000000000C0000000000000000000000C0000000000001
10000000000C0000000000000000000100000000000C000000000000000000000000000000000001
10000000000000C0000000000000000100000000000C0000000000000000000000000C0000000001
1000000000000000C00000000000000100000000000C000000000000000000000000000000000001
100000000000000000C000000000000100000000000C000000000000000000000000000C00000001
100C0C000C00C00C00C00C00C0000000000000100000000000C00000000000000000000000000001
100000000000000000000000000000100000000000C000000000000000000000000000000C000001
100000000000000000000C0000000000000000000000000000000000000000000000000000000001
1000000011111100000000C0000000000000000000000000000000000000000000000000000C0001
100000000000000000000C0000000000000000000000000000000000000000000000000000000001
1000000011111100000000C00000000000000000000000000000000000000000000000000000C001
100000000000000000000C0000000000000000000000000000000C00000000000000000000000001
1000000011111100000000C000000000000000000000000000000000000000000000000000000001
100000000000000000000C0000000000000000000000000000C00000000000000000000000000001
1000000011111100000000C000000000000000000000000000000000000000000000000000000001
100000000000000000000C0000000000000000000000000000000000000000000000000000000001
1000000011111100000000C000000000000000000000000C00000000000000000000000000000001
100000000000000000000C000000000000000000000C000000000000000000000000000000000001
1000000011111100000000C000000000000000000000000000000000000000000000000000000001
100000000000000000000C000000000000000000C000000000000000000000000000000000000001
1000000011111100000000C000000000000000000000000000000000000000000000000000000001
100000000000000000000C0000000000000000000000000000000000000000000000000000000001
1000000011111100000000C00000000000000C000000000000000000000000000000000000000001
100000000000000000000C0000000000000000000000000000000000000000000000000000000001
1000000011111100000000C000000000000000000000000000000000000000000000000000000001
1000000011111100000000C00000000000C000000000000000000000000000000000000000000001
1000000011111100000000C000000000000000000000000000000000000000000000000000000001
100000000000000000000C000000000C000000000000000000000000000000000000000000000001
100000000000000000000C0000000000000000000000000000000000000000000000000000000001
100000000000000000000C0000000C00000000000000000000000000000000000000000000000001
11111111111111111111111111111111111111111111111111111111111111111111111111111111
