1111111111111111111111111111111111
100000000P00000000000C000000000001
1CCCCCCCCCCCCCCCCCCCCCCCCCCCCCCCC1
10C111C000000C00000000000000000001
10000000000C01C0000000C00000C00001
10000C0000000000000000C00000000001
10000000011111100000000C0000000001
100E000000000000011100000C00000001
100000000C000000000000C00000C00001
100001111000000C000000000000000001
10000000000C0000000000C00000000001
1000000000000000011110000000000001
100C0000000100E001000000C000000001
1000000000010000001000000000000001
100000000001000000111100000C000001
100000C000010000000001000000000001
10000000000100000C0001000000000001
1000000000000000011101010000C00001
10C0000C000C0000000000000000000001
1111111111111111111111111111111111
