111111111111111111111111111111
100000000P00000000000C00000001
10C111C000000C0000000001000001
10000000000C01C0000000C00000C1
10000C0000000000000000C0000001
10000000011111100000000C001001
100E000000000000011100000C0001
100000000C000000000000C00010C1
100001111000000C00000000000001
10000000000C0000000000C0001001
100000000000000001111000000001
100C000000010000001000000C0001
100001000001000000100000000001
100000000001000000111100100C01
100000C00001000000000100000001
10000000000100000C000100000001
1000000000000000011101010000C1
10C0000C000C000000000000000001
1000100000000000000001C1000001
100000000000C00000000000000001
1111111111110000C100000C000001
100000000000C000000000C00000C1
1000000C000000000010C000000001
100000000000C00000000000000001
1000C000000000000010000C000001
111111111111111111111111111111
