1111111111111
100000000P111
1001110000001
100000E000001
1111111111111
