1111111111111
100000000P111
10C111C000001
1000000000001
1111111111111
