1111111111111
100000000P111
10C111C000001
100000E000001

