1111111111111
100000000P111
00C111C000001
100000E000001
1111111111111
