1111111111111
100000000P111
10C111C000001
100000E000001
1000000000001
1001100000001
1101111111111
