1111111111111
100000000P111
10C111C000001
10E000E000E011
1111111111111
