1111111111111
1000P111
10C111C000001
100000E000001
1111111111111
