11111111
1EC000E1
10P00C01
1E0100E1
11111111
