1111111111
1000000001
1001111001
100P000001
100C00C001
10000000E1
1001111001
1000000001
1111111111
