1111111111111111111111111111111111111111111111111111111111111111111111111111111
10000000000P0000000000000000000000000000000000000000000000000000000000000000001
1C111C0000000000000000000000000000000000000000000000000000000000000000000000001
1000000000011111100000000C00000000000000000000000000000000000000000000000000001
10E00000000000000000000000000000000011100000C0000000000000000000000000000000001
1C111C0000000000000000000000000000000000000000000000000000000000000000000000001
100000000000000000000000000000000100000000C000000000000000000000000000000000001
100000000000000000000000C000000000000000000000000000000000000000000000000000001
1000000011111100000000C00000000000000000000000000000000000000000000000000000001
10E00000000000000000000000000000000011100000C0000000000000000000000000000000001
100000000000000000000000000000100000000000C000000000000000000000000000000000001
100000000000000000000000000000100000000000C000000000000000000000000000000000001
100000000000000000000000000000100000000000C000000000000000000000000000000000001
100000000000000000000000000000100000000000C000000000000000000000000000000000001
100000000000000000000000000000100000000000C000000000000000000000000000000000001
100000000000000000000000000000100000000000C000000000000000000000000000000000001
100000000000000000000000000000100000000000C000000000000000000000000000000000001
100000000000000000000000000000100000000000C000000000000000000000000000000000001
100000000000000000000000000000100000000000C000000000000000000000000000000000001
100000000000000000000000000000100000000000C000000000000000000000000000000000001
100000000000000000000C000000000000000000000000000000000000000000000000000000001
1000000011111100000000C00000000000000000000000000000000000000000000000000000001
100000000000000000000C000000000000000000000000000000000000000000000000000000001
1000000011111100000000C00000000000000000000000000000000000000000000000000000001
100000000000000000000C000000000000000000000000000000000000000000000000000000001
1000000011111100000000C00000000000000000000000000000000000000000000000000000001
100000000000000000000C000000000000000000000000000000000000000000000000000000001
1000000011111100000000C00000000000000000000000000000000000000000000000000000001
100000000000000000000C000000000000000000000000000000000000000000000000000000001
1000000011111100000000C00000000000000000000000000000000000000000000000000000001
100000000000000000000C000000000000000000000000000000000000000000000000000000001
1000000011111100000000C00000000000000000000000000000000000000000000000000000001
100000000000000000000C000000000000000000000000000000000000000000000000000000001
1000000011111100000000C00000000000000000000000000000000000000000000000000000001
100000000000000000000C000000000000000000000000000000000000000000000000000000001
1000000011111100000000C00000000000000000000000000000000000000000000000000000001
100000000000000000000C000000000000000000000000000000000000000000000000000000001
1000000011111100000000C00000000000000000000000000000000000000000000000000000001
1000000011111100000000C00000000000000000000000000000000000000000000000000000001
1000000011111100000000C00000000000000000000000000000000000000000000000000000001
100000000000000000000C000000000000000000000000000000000000000000000000000000001
100000000000000000000C000000000000000000000000000000000000000000000000000000001
100000000000000000000C000000000000000000000000000000000000000000000000000000001
100000000000000000000C000000000000000000000000000000000000000000000000000000001
1111111111111111111111111111111111111111111111111111111111111111111111111111111
