1111111111111
10000X000P111
10C111C000001
100000E000001
1111111111111
