111111111111111111111111111111
100000000P00000000000000000001
10C111C00000000000000000000001
1000000000000100000000C0000001
1000000000000000000000C0000001
10000000011111100000000C000001
100E000000000000011100000C0001
1000000000000000000000C0000001
100001111000000000000000000001
1000000000000000000000C0000001
100000000000000001111000000001
100C00000001000000100000000001
100000000001000000100000000001
1000000000010E0000000111100001
100000C00001000000000100000001
100000000001000000000100000001
1000E0000000000000111010100001
10000000000C000000000000000001
1000000000000000000000C0000001
100000000000C00000000000000001
1111111111110000C000000C000001
1000000000000000000000C0000001
1000000C0000000000000000000001
100000000000000000000000000001
1000C000000000000000000C000001
111111111111111111111111111111
